R  800 600


NO ./res/wall3.xpm
SO ./res/wall4.xpm
WE ./res/brickimg.xpm
EA ./res/wall1.xpm
S ./res/barrel.xpm

C 0, 255, 255
F 143, 188, 143

11111111111111111
10000000000000001
10000000000000001
10000000000000001
10000000000000001
10000000000000001
10000000000000001
10000000200000001
12000000200000001
10000000000000001
10000000N00000001
10000000000000001
11111111111111111
