R 800 600


NO ./res/wall3.xpm
SO ./res/wall4.xpm
WE ./res/brickimg.xpm
EA ./res/wall1.xpm
S ./res/barrel.xpm

C 94, 47, 18
F 133,195,237


11111111111
10000000001
10000000001
10000000001
10000000001
10000N00001
10000000001
10000000001
11111111111